1,5,7,4,6,9,3,2,8
9,8,6,1,2,3,7,5,4
4,2,3,5,8,7,1,9,6
3,9,2,8,5,1,4,6,7
7,6,8,2,9,4,5,3,1
5,1,4,7,3,6,9,8,2
2,7,5,9,1,8,6,4,3
6,4,9,3,7,2,8,1,5
8,3,1,6,4,5,2,7,9