4,8,3,2,7,1,6,9,5
9,7,6,4,8,5,3,2,1
5,2,1,3,9,6,4,7,8
2,9,4,6,5,8,1,3,7
1,3,8,9,2,7,5,6,4
6,5,7,1,3,4,9,8,2
8,4,2,5,6,3,7,1,9
3,1,9,7,4,2,8,5,6
7,6,5,8,1,9,2,4,3