4,5,1,2,9,6,3,7,8
7,3,6,5,1,8,4,2,9
9,8,2,4,3,7,5,6,1
3,6,9,8,2,1,7,4,5
1,7,5,6,4,9,8,3,2
2,4,8,3,7,5,1,9,6
8,1,3,9,6,4,2,5,7
6,2,7,1,5,3,9,8,4
5,9,4,7,8,2,6,1,3