7,1,2,6,8,3,4,9,5
6,9,3,5,7,4,2,1,8
8,4,5,2,9,1,3,7,6
4,6,9,8,1,7,5,2,3
5,2,7,4,3,6,1,8,9
3,8,1,9,2,5,6,4,7
9,5,4,7,6,2,8,3,1
1,7,6,3,4,8,9,5,2
2,3,8,1,5,9,7,6,4