7,3,4,9,5,8,1,6,2
6,8,5,3,1,2,4,7,9
2,1,9,6,7,4,5,3,8
1,9,7,8,6,3,2,5,4
5,6,8,2,4,7,9,1,3
3,4,2,1,9,5,6,8,7
4,7,3,5,2,6,8,9,1
8,5,1,4,3,9,7,2,6
9,2,6,7,8,1,3,4,5