0,1,2,6,8,0,0,9,0
6,0,0,0,0,4,0,1,0
8,0,5,2,0,0,3,7,0
0,0,0,0,0,7,5,2,3
0,0,0,4,0,6,0,0,0
3,8,1,9,0,0,0,0,0
0,5,4,0,0,2,8,0,1
0,7,0,3,0,0,0,0,2
0,3,0,0,5,9,7,6,0