7,0,0,0,5,8,0,0,2
6,0,5,0,0,2,0,0,9
2,0,9,0,7,0,0,3,8
0,9,7,8,0,3,2,5,0
0,0,0,2,0,0,0,1,3
3,4,0,1,9,0,6,8,0
0,0,3,0,0,0,0,9,0
8,0,0,0,3,0,7,0,0
0,2,6,7,8,0,3,0,0