0,8,0,0,0,1,6,0,0
0,7,0,4,0,0,0,2,1
5,0,0,3,9,6,0,0,0
2,0,4,0,5,0,1,3,0
0,0,8,9,0,7,5,0,0
0,5,7,0,3,0,9,0,0
0,0,0,5,6,3,0,0,9
3,1,0,0,0,2,0,5,0
0,0,5,8,0,0,0,4,0