4,0,1,2,0,6,0,0,0
0,3,6,0,0,0,4,0,9
0,0,2,0,3,7,0,0,1
3,6,0,0,2,0,0,0,5
1,0,0,0,4,9,8,3,2
0,4,0,0,0,5,0,9,6
0,1,0,0,6,0,0,5,0
0,0,7,1,0,0,0,0,4
0,9,0,7,8,2,6,0,3